{
  "legend": {
    "l": "record",
    "t": "goldrecord",
    "T": "platinumrecord"
  },
  "layout": [
    ["#", "#", "#", "#", "#", "#", "#", "#", "#", "#", "#", "#", "#", "#", "#", "#", "#", "#", "#", "#", "#"],
    ["#", "X", "l", " ", " ", " ", " ", " ", "1", " ", "U", " ", "2", " ", " ", " ", " ", " ", "l", "X", "#"],
    ["#", " ", " ", " ", " ", "l", "l", " ", " ", " ", " ", " ", " ", " ", "l", "l", " ", " ", " ", " ", "#"],
    ["#", "#", "#", "t", " ", "#", "#", "#", "#", "#", "#", "#", "#", "#", "#", "#", " ", "t", "#", "#", "#"],
    ["#", "t", " ", "#", " ", "#", "T", " ", "t", "l", "T", "l", "t", " ", "T", "#", " ", "#", " ", "t", "#"],
    ["#", "#", " ", " ", " ", "#", "T", "#", "l", " ", " ", " ", "l", "#", "T", "#", " ", " ", " ", "#", "#"],
    ["#", "l", " ", "#", "#", "#", "#", "#", "#", "X", " ", "X", "#", "#", "#", "#", "#", "#", " ", "l", "#"],
    ["#", "#", " ", " ", "#", " ", " ", " ", "#", " ", "x", " ", "#", " ", " ", " ", "#", " ", " ", "#", "#"],
    ["#", "T", "#", " ", " ", " ", "#", "t", "#", " ", " ", " ", "#", "t", "#", " ", " ", " ", "#", "T", "#"],
    ["#", "x", "#", "l", "#", "#", "#", "#", "#", " ", "#", " ", "#", "#", "#", "#", "#", "l", "#", "x", "#"],
    ["#", " ", " ", " ", "#", " ", " ", " ", "#", " ", "l", " ", "#", " ", " ", " ", "#", " ", " ", " ", "#"],
    ["#", "#", "#", " ", "#", " ", "#", " ", "#", " ", "#", " ", "#", " ", "#", " ", "#", " ", "#", "#", "#"],
    ["#", "t", " ", " ", " ", " ", "#", " ", " ", " ", "#", " ", " ", " ", "#", " ", " ", " ", " ", "t", "#"],
    ["#", "l", "#", "#", "#", "l", "#", "t", "#", "t", "#", "t", "#", "t", "#", "l", "#", "#", "#", "l", "#"],
    ["#", "#", "#", "#", "#", "#", "#", "#", "#", "#", "#", "#", "#", "#", "#", "#", "#", "#", "#", "#", "#"]
  ]
}
